8 7
1 1 1 1 1 1 1
1 0 0 0 0 0 1
1 0 3 2 3 0 1
1 0 2 3 2 0 1
1 0 3 2 3 0 1
1 0 2 3 2 0 1
1 0 0 5 0 0 1
1 1 1 1 1 1 1
