8 10
4 1 1 1 1 4 4 4 4 4
4 1 0 0 1 1 1 1 4 4
4 1 0 0 0 0 0 1 1 4
1 1 0 1 1 0 0 0 1 4
1 3 0 3 1 0 5 2 1 1
1 0 0 0 1 0 2 2 0 1
1 0 0 3 1 0 0 0 0 1
1 1 1 1 1 1 1 1 1 1
